l 00 t 8
########
#....VC#
#..aaVC#
#..zzSC@
#..D.S.#
#..DGbb#
#..DG..#
########

l 01 t 8
########
#......#
#....B.#
#zz.CB.@
#...CB.#
#....aa#
#......#
########

l 02 t 8
########
#aaa.B.#
#....B.#
#zz.CB.@
#...C..#
#...ddd#
#......#
########

