l 00 t 8
########
#......#
#....B.#
#.rrCB.@
#...CB.#
#....aa#
#......#
########

l 01 t 8
########
#aaa.B.#
#....B.#
#rr.CB.@
#...C..#
#...ddd#
#......#
########

