l 00 t 8
########
#......#
#......#
#zz....@
#......#
#......#
#......#
########

l 01 t 8
########
#aaa.B.#
#....B.#
#zz.CB.@
#...C..#
#...ddd#
#......#
########

