l 00 t 8
########
#....VC#
#..aaVC#
#..rrSC@
#..D.S.#
#..DGzz#
#..DG..#
########

