l 00 t 8
########
#....VC#
#..aaVC#
#..zzSC@
#..D.S.#
#..DGbb#
#..DG..#
########
